 , , , , , , , , , , , , , , , ,f,f,f,f,f,f,f,f
 , , , , , , , , , , , , , , , , , , , , , , ,f
l, , ,f,f,f, , , , , , ,f,f,f, , , , , , , , ,f
l, , , , , , , , , , , , , , , , , , , , , , ,f
 ,f,f,f,f,f,f,f,f,f,f,f,f,f,f,f,f,f,f,f,f,f,f,f
