 , , , , , , , , , , , , , , , ,a,a,a,a,a,a,a,e
 , , , , , , , , , , , , , , , , , , , , , , ,e
c, , ,a,b,a, , , , , , ,a,b,a, , , , , , , , ,e
c, , , , , , , , , , , , , , , , , , , , , , ,e
d,a,a,b,a,a,a,b,a,a,a,a,a,a,a,a,b,a,a,a,a,a,a,e
