 , , , , , , , , , , , , , , , ,a,a,a,a,a,a,a,a
 , , , , , , , , , , , , , , , , , , , , , , ,a
c, , ,a,b,a, , , , , , ,a,b,a, , , , , , , , ,a
c, , , , , , , , , , , , , , , , , , , , , , ,a
d,a,a,b,a,a,a,b,a,a,a,a,a,a,a,a,b,a,a,a,a,a,a,a
