 , , , , , , , , , , , , , , , ,f,g,g,g,g,g,f,e
 , , , , , , , , , , , , , , , , , , , , , , ,e
c, , ,f,g,f, , , , , , ,f,g,f, , , , , , , , ,e
c, , , , , , , , , , , , , , , , , , , , , , ,e
d,a,a,b,a,a,a,b,a,a,a,a,a,a,a,a,b,a,a,a,a,a,a,e
